### ###       ##  ##            ###   ###               ##      ##
 #   #   ###   #   #   ###       #  #  #   ###  ##  ##   #      #
 #   #  #   #  #   #  #   #      #  #  #  #   #  # #  #  #   ## #
 #####  #####  #   #  #   #      #  #  #  #   #  ##      #  #  ##
 #   #  #      #   #  #   #      #  #  #  #   #  #       #  #   #
 #   #  #   #  #   #  #   #      #  #  #  #   #  #       #  #  ##
### ###  ###  ### ###  ###        ## ##    ###  ##      ###  ## ##
